 -10,20 10,20 10,-6 -10,-6
 1,25
 10,-6 14,-6 11,-11 0,-18 -11,-22 -15,-34 -22,-34 -23,-34 -23,-26 -19,-11 -14,-6 -10,-6
 0,34
 -4,-74 -24,-65 -35,-53 -25,-52 -23,-50 -26,-36 -22,-36 -15,-36 -13,-36 -3,-36 -1,-36
 2,23
 8,-40 14,-43 10,-74 -1,-85 -4,-74 -1,-36
 0,34
 -22,-34 -15,-34 -15,-36 -22,-36
 1,9
 -13,-36 -13,-34 -9,-34 -3,-34 -3,-36
 2,16
 13,-35 8,-40 -1,-36 -1,-34 7,-29
 2,17
 7,-29 -1,-34 -3,-34 -9,-34 -6,-28 1,-26
 1,34
 14,-6 25,-6 26,-21 7,-29 1,-26 -6,-28 -9,-34 -13,-34 -15,-34 -11,-22 0,-18 3,-19 4,-20 6,-21 8,-21 9,-22 16,-19 15,-18 14,-16 13,-15 12,-13 11,-11
 -6,34
 -23,-34 -29,-34 -38,-35 -39,-34 -38,-25 -30,-6 -14,-6 -19,-11 -23,-26
 5,34
 0,-18 11,-11 12,-13 3,-19
 -1,34
 14,-16 15,-18 8,-21 6,-21
 -4,34
 15,-18 16,-19 9,-22 8,-21
 -5,34
 13,-15 14,-16 6,-21 4,-20
 -3,34
 37,-34 34,-30 32,-24 26,-21 25,-6 43,-13 55,-35
 3,23
 12,-13 13,-15 4,-20 3,-19
 -2,34
 -35,-53 -38,-51 -39,-37 -38,-36 -38,-35 -29,-34 -29,-35 -26,-36 -23,-50 -25,-52
 5,23
 33,-99 36,-119 -24,-110 1,-97 11,-88 24,-85 28,-89
 10,34
 58,-43 63,-63 58,-80 41,-94 50,-77 55,-62
 0,13
 26,-21 26,-29 13,-35 7,-29
 -6,17
 34,-30 26,-29 26,-21 32,-24
 3,17
 14,-43 16,-39 25,-45 25,-48
 11,30
 31,-48 37,-34 55,-35 58,-43 55,-62 50,-77 41,-94 37,-97 34,-78
 0,23
 34,-78 37,-97 33,-99 28,-89 24,-85 26,-73
 3,34
 14,-43 25,-48 26,-73 10,-74
 8,34
 25,-48 31,-48 34,-78 26,-73
 0,34
 11,-88 1,-97 -1,-85 10,-74
 2,34
 24,-85 11,-88 10,-74 26,-73
 9,34
 16,-39 21,-35 27,-33 31,-37 31,-41 25,-45
 15,30
