 -10,10 10,10 14,-3 13,-12 6,-3 -2,-3 -3,-19 -10,-21
 -3,12
 10,10 30,10 30,-10 17,-11 13,-12 14,-3
 -3,12
 -10,-21 -3,-19 -2,-3 6,-3 13,-12 10,-30 -5,-24
 -3,4
 -10,-21 -3,-19 -2,-3 6,-3 13,-12 10,-30 -10,-30
 7,12
 13,-12 17,-11 30,-10 30,-30 10,-30
 -3,12
