 -9,-9 -9,8 11,8 11,-13 31,-13 32,-29 13,-42 13,-42 -3,-42 -3,-51 -10,-51 -20,-51 -29,-51 -32,-51 -32,-25 -32,-20 -28,-20
 -3,25
 -20,-70 -20,-51 -10,-51 -3,-51 -3,-42 13,-42 13,-60 13,-65 5,-82 -7,-82
 -3,6
 -10,-51 -3,-51 -3,-42 13,-42 13,-60 23,-60 23,-62 71,-62 71,-81 27,-81 27,-85 13,-85 9,-75 -2,-73 -10,-73 -10,-73 -10,-56 -10,-54
 8,25
 13,-65 33,-65 33,-61 30,-60 39,-42 42,-49 50,-58 45,-74 47,-93 33,-87 33,-83 31,-82 5,-82
 -3,6
 27,-85 28,-88 31,-88 33,-101 18,-101 14,-98 13,-85
 -3,25
 47,-93 39,-101 33,-101 31,-88 33,-87
 -3,16
 -29,-54 -29,-51 -20,-51 -20,-54
 8,25
 -10,-73 -32,-73 -32,-54 -29,-54 -20,-54 -10,-54 -10,-56 -10,-73
 8,52
 13,-42 32,-29 39,-42 30,-60 23,-60 13,-60
 -3,25
 -46,-54 -56,-54 -62,-35 -56,-35 -46,-47
 2,52
 -32,-51 -32,-54 -46,-54 -46,-47 -56,-35 -62,-35 -62,-20 -32,-20 -32,-25 -32,-51
 -3,52
 -32,-73 -62,-73 -56,-54 -46,-54 -32,-54
 8,52
 -32,-25 -30,-25 -30,-6 18,-6 18,-91 -8,-91 -8,-73 -10,-73 -10,-56 -8,-56 -8,-51 -32,-51
 28,49
 -56,-54 -61,-47 -73,-47 -79,-54 -98,-54 -112,-91 -163,-91 -163,-1 -111,-1 -98,-35 -62,-35
 2,33
 -62,-73 -79,-54 -56,-54
 8,33
 -79,-54 -73,-47 -61,-47 -56,-54
 5,33
