 -9,-9 -9,8 11,8 11,2 11,-13 26,-13 31,-21 32,-29 27,-30 21,-21 -21,-21 -29,-27 -37,-27 -44,-20 -28,-20
 -3,25
 -20,-69 -10,-59 -10,-51 -3,-51 13,-42 13,-60 13,-65 5,-82 -7,-82
 -3,6
 -10,-51 -3,-51 13,-42 13,-60 23,-60 23,-62 54,-62 71,-62 71,-82 27,-82 27,-86 13,-86 9,-75 -2,-73 -15,-73 -10,-67 -10,-54
 8,25
 13,-65 33,-65 33,-61 30,-60 31,-55 39,-42 42,-49 50,-58 45,-74 47,-93 33,-86 33,-84 31,-82 27,-82 13,-82 5,-82
 -3,6
 27,-86 29,-88 31,-88 40,-105 18,-105 13,-100 13,-86
 -3,25
 47,-93 40,-105 31,-88 33,-86
 -3,16
 -29,-54 -29,-51 -13,-51 -13,-54
 8,25
 -15,-73 -32,-73 -32,-54 -29,-54 -13,-54 -10,-54 -10,-67
 8,48
 13,-42 27,-30 32,-29 35,-35 39,-42 31,-55 30,-60 23,-60 13,-60
 -3,25
 -46,-54 -56,-54 -62,-35 -56,-35 -46,-47
 2,48
 -32,-51 -32,-54 -46,-54 -46,-47 -56,-35 -62,-35 -62,-20 -44,-20 -37,-27 -29,-27 -21,-21 21,-21 27,-30 13,-42 -3,-42 -3,-51 -10,-51 -13,-51 -29,-51
 -3,48
 -32,-73 -62,-73 -56,-54 -46,-54 -32,-54
 8,48
 -56,-54 -61,-47 -73,-47 -79,-54 -98,-54 -112,-91 -163,-91 -163,-1 -111,-1 -98,-35 -62,-35
 2,33
 -62,-73 -79,-54 -56,-54
 8,33
 -79,-54 -73,-47 -61,-47 -56,-54
 5,33
 13,-82 27,-82 27,-86 13,-86
 -3,6
 40,-105 40,-121 18,-121 18,-105
 6,25
 35,-35 40,-31 40,-21 31,-21 26,-13 11,2 11,8 40,4 71,-22 71,-58 54,-58 37,-58 31,-55 39,-42
 8,21
 54,-58 71,-58 71,-62 54,-62
 8,21
 26,-13 11,-13 11,2
 8,25
 27,-30 32,-39 32,-95 -17,-95 -32,-81 -32,-73 -15,-73 -10,-67 -10,-54 -10,-51 -3,-51 13,-42
 28,48
 -3,-51 -3,-42 13,-42
 8,48
 -3,-42 13,-42 -3,-51
 -3,6
 -29,8 -9,8 -9,-9 -28,-20 -44,-20
 -3,15
 -29,-51 -13,-51 -13,-54 -29,-54
 28,48
