 -10,10 10,10 30,10 30,-10 13,-12 13,-12 6,-3 -2,-3 -3,-19 -10,-21
 -3,16
 -10,-21 -3,-19 -2,-3 6,-3 13,-12 10,-30 12,-43 5,-54 -7,-54
 -3,6
 -10,-21 -3,-19 -2,-3 6,-3 13,-12 10,-30 23,-30 23,-39 15,-40 9,-41 -9,-38
 7,16
 13,-12 30,-10 30,-16 30,-30 23,-30 10,-30
 -3,16
 12,-43 27,-40 33,-35 33,-31 30,-30 30,-16 42,-19 50,-28 45,-44 31,-52 5,-54
 -3,10
