 -10,10 10,10 10,-10 -10,-10
 0,10
 10,10 30,10 30,-10 10,-10
 0,10
 -10,-10 10,-10 10,-30 -5,-24
 0,4
 10,-10 30,-10 30,-30 10,-30
 0,10
 -10,-10 10,-10 10,-30 -10,-30
 7,12
